# ##################
#   #        #  # ##
### # # ## # # ##  #
#   # # #   #    # #
# ## #  # ##  #### #
# #    #  #  #     #
#  # # ## ##   ### #
##   #  #   ###    #
### ###  ##     ## #
################## #