# ########
# ## ### #
#    ##  #
####    ##
# ## #####
#    #   #
# #### # #
#      # #
## ## ## #
######## #